09900000000990000000099000000009900000000
00000000000990000000000000000009900000000
99999113333990000000999991100009900000000
00009551100222200000000090000002222000000
00009001111222200000000090000002222000000
00002000000990000000000090000002222000000
00009000000990000000000090000002222000000
00000000000990000000000000000009900000000
00000000000660000005555555555509900000000
00000000000660000002222222222229900000000
09955555555990000001111111111119900000000
00011155112990000000000000000009900000000
99999111112990000000999991100009900000000
00009000000000000000999991100009900000000
00002000000990000000999991100009900000000
00009000000990000000000090000009900000000
00000000000990000000000090000009900000000
00000000000990000000000090000009900000000
00000000000990000000000090000009900000000
09900000000990022222299000000009900000000
00000000000990022222222220000009900000000
99999110000990000000999991100009900000001
00009000000222200000000090000002222000001
00009000000222200000000090000002222000000
00002000000990000000000090000002222000000
00009000000990000000000090000002222000000
00000000000990000000000550000009900000000
00000000000660000000000550000009900000000
00000000000660000000000550000009900000000
09900000000990000000000550000009900000000
00000000000990000000000550000009900000000
99999110000990000000999991100009900000000
00009000000000000000999991100009900000000
00002000000990000000999991100009900000000
00009000000990000000000090000009900000000
00000000000990000000000090000009900000000
00000000000990000000000090000009900000000
00000000000990000000000000000009900000000
00000000000990000000000090000009900000000
00000000000990000000000090000009900000000
00000000000990000000000090000009900000000
