0055555555
0055555555
0055555555
9099999955
9294444444
0294499994
0222290000
9992290000
6666690000
6666660000
